WE ./textures/wall_1.xpm
SO ./textures/wall_2.xpm
EA ./textures/wall_3.xpm
NO ./textures/wall_4.xpm
F 133,117,92
C 82,39,16
E 225,100,0
E 1500,200,0
E 1500,250,0
E 1500,300,0
E 2500,350,0
E 650,125,0
11111111111          1111111111
10000000001111111111100000000001
1E00000000D0000D0000D00000000001
11000000111111111111100000000001
111D111000001100000D000000000001
  101111100000001011111000010001
  1001111000010000111111100000011111
111000D00000001111      1111000000011         
1111D11111101111            1000000001   111111
1100000000101                111100000111100001
 100000100101                    11000000000001
 100100100001                      111111111101
 11000000011111111111111111111111111111111111D11
   1000000D00000000000DDDDDDD0000000000000000001
    11111111111111111111111110000000001000000001
                            10000000000011000001
                            10110001000011000001
                            10010000000000000001
                            10000100000100000001
                            10000000000000000001
                            11111111111111111111
