WE ./textures/wall_1.xpm
SO ./textures/wall_2.xpm
EA ./textures/wall_3.xpm
NO ./textures/wall_4.xpm

F 133,117,92
C 82,39,16

E 200,200,0
E 150,150,0
E 300,150,0
E 400,150,0
E 500,150,0

111111111111111111
10100W100010000101
10D000D0001001000111
10111D1000000000011
10000000001100000111111
10000000110001000000111111
 1111D1D101110010000000001
    100000001011100011111
1111000001000001000111
11000001000001111111
11110000000000000101
111111111111010101111
11111100000000011
10000000111111111
111111111






