WE ./textures/wall_1.xpm
SO ./textures/wall_2.xpm
EA ./textures/wall_3.xpm
NO ./textures/wall_4.xpm

F 133,117,92
C 82,39,16

111111111111111111        
100000000010000101
1000E000000001000111
1000001110000000011
10000000001100000111111
10000000110001000000111111
 1111010101110010000000001
    100000001010100011111
1111000001000000000111
11000001000001111111
11110000000000000101
111111111111010101111
11111100000000011
10000000111111111
111111111






