111111111111111111
100000010000000101
100000000100010001
100000000100000001
100000000101000001
1000000100010000111111
10000000010100000000W1
1000000001011100011111
100000000100000101
111111111111111111
111111111111111111
111111111111111111
111111111111111111
111111111111111111
111111111111111111
111111111111111111
111111111111111111
111111111111111111