WE ./textures/grass_block_side.xpm
SO ./textures/cobblestone.xpm
EA       ./textures/oak_planks.xpm
NO ./textures/bricks.xpm

F 0,200,0
C 0,0,200

E 400,600,0
E 200,600,0

111111111111111111
10000W010000000101
10000000010001000111
1000000001000000011
10001011110100000111111
1001 1  110001000000111111
 11 1011101110010000000001
    100000001011100011111
1111000001000001000111
11000001000001111111
11110000000000000101
111111111111010101111
11111100000000011
10000000111111111
111111111






