
SO ./textures/cobblestone.xpm
F 0,200,0
WE ./textures/grass_block_side.xpm
EA       ./textures/oak_planks.xpm


C     0,0,200





NO ./textures/bricks.xpm

111111111111111111
100000010000000101
10000000010001000111
1000000001000S00011
10001011110100000111111
1001 1  1100010010000111111
 11 1011101111010000000001
    100000001011100011111
111100000100000101111
11000001000001111111
11110000000000000101
111111111111010101111
111111000000000011
10000000111111111
111111111






