WE ./textures/wall_1.xpm
SO ./textures/wall_2.xpm
EA ./textures/wall_3.xpm
NO ./textures/wall_4.xpm

F 133,117,92
C 82,39,16

E 200,200,0

111111111111111111
10000W000000000101
10000000000001000111
1000000000000000011
10000000000100000111111
10000000110001000000111111
 1111011101110010000000001
    100000001011100011111
1111000001000001000111
11000001000001111111
11110000000000000101
111111111111010101111
11111100000000011
10000000111111111
111111111






