WE ./textures/wall_1.xpm
SO ./textures/wall_2.xpm
EA ./textures/wall_3.xpm
NO ./textures/wall_4.xpm

F 133,117,92
C 82,39,16

E 65,65,0
E 60,145,0
E 60,286,0
E 60,594,0
E 60,653,0
E 234,65,0
E 365,345,0
E 600,700,0
E 200,65,0
E 400,65,0
E 1000,584,0


111111111111111111111111111111111111111111111111
1E000000000000000000000000D000000000000000000001
100000000100000000000000001000000000000000000001
100000000D00000000000000000000000000000000000001
100000000100000000001D1001D100000000000000000001
100000000000000000001D10000000000000000000000001
100000000000000000001D10000000000000000000000001
1000000000000001D11D1D10000000000000000000000001
100000000000000000000000000000000000000000000001
100000000000000000000000000000000000000000000001
100000000000000000000000000000000000000000000001
100000000000000000000000000000000000000000000001
100000000000000000000000000000000000000000000001
100000000000000000000000000000000000000000000001
100000000000000000000000000000000000000000000001
100000000000000000000000000000000000000000000001
100000000000000000000000000000000000000000000001
100000000000000000000000000000000000000000000001
100000000000000000000000000000000000000000000001
100000000000000000000000000000000000000000000001
100000000000000000000000000000000000000000000001
100000000000000000000000000000000000000000000001
100000000000000000000000000000000000000000000001
100000000000000000000000000000000000000000000001
100000000000000000000000000000000000000000000001
100000000000000000000000000000000000000000000001
100000000000000000000000000000000000000000000001
100000000000000000000000000000000000000000000001
100000000000000000000000000000000000000000000001
111111111111111111111111111111111111111111111111
