11111111
10000001
10000001
10101001
10000001
101N1001
10000001
11111111