WE ./textures/wall_1.xpm
SO ./textures/wall_2.xpm
SO ./textures/wall_2.xpm
EA ./textures/wall_3.xpm
NO ./textures/wall_2.xpm

F 200,200,200
C 255,00,0

1111111
100 001
1111111







