1111111111
1S10000001
1010111001
1010101001
1010001001
1010101001
1000101001
1010111101
1010000001
1111111111